[
    {
        "id": 0,
        "name": "Classic",
        "tiles": [
            [ 0, 1, 0, 0, 2, 0, 0, 1, 0],
            [ 0, 0, 0, 0, 0, 0, 0, 0, 0],
            [ 0, 0, 0, 0, 0, 0, 0, 0, 0],
            [ 0, 0, 0, 0, 0, 0, 0, 0, 0],
            [ 0, 1, 0, 0, 2, 0, 0, 1, 0],
            [ 0, 0, 0, 0, 0, 0, 0, 0, 0],
            [ 0, 0, 0, 0, 0, 0, 0, 0, 0],
            [ 0, 0, 0, 0, 0, 0, 0, 0, 0],
            [ 0, 1, 0, 0, 2, 0, 0, 1, 0]
        ]
    },
    {
        "id": 1,
        "name": "Star",
        "tiles": [
            [ 0, 0, 0, 0, 2, 0, 0, 0, 0],
            [ 0, 1, 0, 0, 0, 0, 0, 1, 0],
            [ 0, 1, 0, 0, 1, 0, 1, 1, 0],
            [ 0, 0, 1, 1, 1, 1, 1, 0, 0],
            [ 0, 1, 1, 1, 2, 1, 1, 1, 0],
            [ 0, 0, 0, 1, 1, 1, 0, 0, 0],
            [ 0, 0, 1, 0, 0, 0, 1, 0, 0],
            [ 0, 1, 0, 0, 0, 0, 0, 1, 0],
            [ 0, 0, 0, 0, 0, 0, 0, 0, 0]
        ]
    },
    {
        "id": 2,
        "name": "Plaza",
        "tiles": [
            [ 0, 0, 0, 0, 1, 0, 0, 0, 0],
            [ 0, 2, 0, 0, 0, 0, 0, 2, 0],
            [ 0, 2, 0, 0, 0, 0, 0, 2, 0],
            [ 0, 0, 0, 0, 0, 0, 0, 0, 0],
            [ 1, 0, 0, 0, 1, 0, 0, 0, 1],
            [ 0, 0, 0, 0, 0, 0, 0, 0, 0],
            [ 0, 2, 0, 0, 0, 0, 0, 2, 0],
            [ 0, 2, 0, 0, 0, 0, 0, 2, 0],
            [ 0, 0, 0, 0, 1, 0, 0, 0, 0]
        ]
    },
    {
        "id": 3,
        "name": "Castle",
        "tiles": [
            [ 0, 0, 0, 0, 0, 0, 0, 0, 0],
            [ 0, 0, 0, 2, 0, 2, 0, 0, 0],
            [ 0, 0, 0, 0, 0, 0, 0, 0, 0],
            [ 0, 2, 0, 0, 0, 0, 0, 2, 0],
            [ 0, 0, 0, 0, 1, 0, 0, 0, 0],
            [ 0, 2, 0, 0, 0, 0, 0, 2, 0],
            [ 0, 0, 0, 0, 0, 0, 0, 0, 0],
            [ 0, 0, 0, 2, 0, 2, 0, 0, 0],
            [ 0, 0, 0, 0, 0, 0, 0, 0, 0]
        ]
    },
    {
        "id": 4,
        "name": "Symmetry",
        "tiles": [
            [ 0, 0, 2, 0, 0, 0, 0, 0, 0],
            [ 0, 0, 0, 0, 0, 0, 2, 0, 0],
            [ 0, 0, 0, 0, 0, 0, 0, 0, 0],
            [ 0, 0, 0, 1, 0, 1, 0, 0, 0],
            [ 2, 0, 0, 0, 0, 0, 0, 0, 2],
            [ 0, 0, 0, 1, 0, 1, 0, 0, 0],
            [ 0, 0, 0, 0, 0, 0, 0, 0, 0],
            [ 0, 0, 2, 0, 0, 0, 0, 0, 0],
            [ 0, 0, 0, 0, 0, 0, 2, 0, 0]
        ]
    },
    {
        "id": 5,
        "name": "Pillars",
        "tiles": [
            [ 0, 0, 0, 0, 0, 0, 0, 0, 0],
            [ 0, 2, 0, 0, 0, 0, 0, 2, 0],
            [ 0, 2, 0, 0, 0, 0, 0, 2, 0],
            [ 0, 0, 0, 0, 0, 0, 0, 0, 0],
            [ 0, 0, 1, 0, 1, 0, 1, 0, 0],
            [ 0, 0, 0, 0, 0, 0, 0, 0, 0],
            [ 0, 2, 0, 0, 0, 0, 0, 2, 0],
            [ 0, 2, 0, 0, 0, 0, 0, 2, 0],
            [ 0, 0, 0, 0, 0, 0, 0, 0, 0]
        ]
    },
    {
        "id": 6,
        "name": "Breakout",
        "tiles": [
            [ 0, 2, 0, 0, 0, 0, 1, 0, 0],
            [ 0, 2, 0, 0, 0, 0, 0, 2, 2],
            [ 1, 0, 0, 0, 0, 0, 0, 0, 0],
            [ 0, 0, 0, 0, 0, 0, 0, 0, 0],
            [ 0, 0, 0, 0, 0, 0, 0, 0, 0],
            [ 0, 0, 0, 0, 0, 0, 0, 0, 0],
            [ 0, 0, 0, 0, 0, 0, 0, 0, 1],
            [ 2, 2, 0, 0, 0, 0, 0, 2, 0],
            [ 0, 0, 1, 0, 0, 0, 0, 2, 0]
        ]
    }
]