[
    {
        "id": 0,
        "name": "Plaza",
        "tiles": [
            [ 0, 0, 0, 0, 1, 0, 0, 0, 0],
            [ 0, 2, 0, 0, 0, 0, 0, 2, 0],
            [ 0, 2, 0, 0, 0, 0, 0, 2, 0],
            [ 0, 0, 0, 0, 0, 0, 0, 0, 0],
            [ 1, 0, 0, 0, 1, 0, 0, 0, 1],
            [ 0, 0, 0, 0, 0, 0, 0, 0, 0],
            [ 0, 2, 0, 0, 0, 0, 0, 2, 0],
            [ 0, 2, 0, 0, 0, 0, 0, 2, 0],
            [ 0, 0, 0, 0, 1, 0, 0, 0, 0]
        ]
    },
    {
        "id": 1,
        "name": "Castle",
        "tiles": [
            [ 0, 0, 0, 0, 0, 0, 0, 0, 0],
            [ 0, 0, 0, 2, 0, 2, 0, 0, 0],
            [ 0, 0, 0, 0, 0, 0, 0, 0, 0],
            [ 0, 2, 0, 0, 0, 0, 0, 2, 0],
            [ 0, 0, 0, 0, 1, 0, 0, 0, 0],
            [ 0, 2, 0, 0, 0, 0, 0, 2, 0],
            [ 0, 0, 0, 0, 0, 0, 0, 0, 0],
            [ 0, 0, 0, 2, 0, 2, 0, 0, 0],
            [ 0, 0, 0, 0, 0, 0, 0, 0, 0]
        ]
    },
    {
        "id": 2,
        "name": "Symmetry",
        "tiles": [
            [ 0, 0, 0, 0, 0, 0, 2, 0, 0],
            [ 0, 0, 2, 0, 0, 0, 0, 0, 0],
            [ 0, 0, 0, 0, 0, 0, 0, 0, 0],
            [ 0, 0, 0, 1, 0, 1, 0, 0, 0],
            [ 2, 0, 0, 0, 0, 0, 0, 0, 2],
            [ 0, 0, 0, 1, 0, 1, 0, 0, 0],
            [ 0, 0, 0, 0, 0, 0, 0, 0, 0],
            [ 0, 0, 0, 0, 0, 0, 2, 0, 0],
            [ 0, 0, 2, 0, 0, 0, 0, 0, 0]
        ]
    },
    {
        "id": 3,
        "name": "Pillars",
        "tiles": [
            [ 0, 0, 0, 0, 0, 0, 0, 0, 0],
            [ 0, 2, 0, 0, 0, 0, 0, 2, 0],
            [ 0, 2, 0, 0, 0, 0, 0, 2, 0],
            [ 0, 0, 0, 0, 0, 0, 0, 0, 0],
            [ 0, 0, 1, 0, 1, 0, 1, 0, 0],
            [ 0, 0, 0, 0, 0, 0, 0, 0, 0],
            [ 0, 2, 0, 0, 0, 0, 0, 2, 0],
            [ 0, 2, 0, 0, 0, 0, 0, 2, 0],
            [ 0, 0, 0, 0, 0, 0, 0, 0, 0]
        ]
    },
    {
        "id": 4,
        "name": "Breakout",
        "tiles": [
            [ 0, 0, 1, 0, 0, 0, 0, 2, 0],
            [ 2, 2, 0, 0, 0, 0, 0, 2, 0],
            [ 0, 0, 0, 0, 0, 0, 0, 0, 1],
            [ 0, 0, 0, 0, 0, 0, 0, 0, 0],
            [ 0, 0, 0, 0, 0, 0, 0, 0, 0],
            [ 0, 0, 0, 0, 0, 0, 0, 0, 0],
            [ 1, 0, 0, 0, 0, 0, 0, 0, 0],
            [ 0, 2, 0, 0, 0, 0, 0, 2, 2],
            [ 0, 2, 0, 0, 0, 0, 1, 0, 0]
        ]
    }
]