[
    {
        "id": 0,
        "name": "Classic",
        "tiles": [
            [ 0, 1, 0, 0, 2, 0, 0, 1, 0],
            [ 0, 0, 0, 0, 0, 0, 0, 0, 0],
            [ 0, 0, 0, 0, 0, 0, 0, 0, 0],
            [ 0, 0, 0, 0, 0, 0, 0, 0, 0],
            [ 0, 1, 0, 0, 2, 0, 0, 1, 0],
            [ 0, 0, 0, 0, 0, 0, 0, 0, 0],
            [ 0, 0, 0, 0, 0, 0, 0, 0, 0],
            [ 0, 0, 0, 0, 0, 0, 0, 0, 0],
            [ 0, 1, 0, 0, 2, 0, 0, 1, 0]
        ]
    },
    {
        "id": 1,
        "name": "Star",
        "tiles": [
            [ 0, 0, 0, 0, 2, 0, 0, 0, 0],
            [ 0, 1, 0, 0, 0, 0, 0, 1, 0],
            [ 0, 1, 0, 0, 1, 0, 1, 1, 0],
            [ 0, 0, 1, 1, 1, 1, 1, 0, 0],
            [ 0, 1, 1, 1, 2, 1, 1, 1, 0],
            [ 0, 0, 0, 1, 1, 1, 0, 0, 0],
            [ 0, 0, 1, 0, 0, 0, 1, 0, 0],
            [ 0, 1, 0, 0, 0, 0, 0, 1, 0],
            [ 0, 0, 0, 0, 0, 0, 0, 0, 0]
        ]
    }
]